11111111111111111111111111
10000001000000000000000001
101E0101111000001010010001
10100100101010100010010001
100PC000000000000000000101
11111111111111111111111111
