11111111111111111111111111
10000001000000000000000001
101E0101111000001010010001
10100100101010100010010001
100P0000000C00000000000101
11111111111111111110111111
11111111111111111110111111
11111111111111111110111111
10000001000000000000000001
10100101111000001010010001
10100100101010100010010001
10000000000C00000000000101
11111111111111111111111111