11111111111111111111111111
100000010000000000000C0001
101001011110CC001010010001
101E0100101010100010010001
1PC000000000C0000CC0000101
11111111111111111111111111
